[header]
width=60
height=31

[layer]
type=background
data=
1,0,0,0,0,0,0,0,0,0,0,0,0,0,0,0,0,0,0,0,0,0,0,0,0,0,0,0,0,0,0,0,0,0,0,0,0,0,0,0,0,0,0,0,0,0,0,0,0,0,0,0,0,0,0,0,0,0,0,0,
0,0,0,0,0,0,0,0,0,0,0,0,0,0,0,0,0,0,0,0,0,0,0,0,0,0,0,0,0,0,0,0,0,0,0,0,0,0,0,0,0,0,0,0,0,0,0,0,0,0,0,0,0,0,0,0,0,0,0,0,
0,0,0,0,0,0,0,0,0,0,0,0,0,0,0,0,0,0,0,0,0,0,0,0,0,0,0,0,0,0,0,0,0,0,0,0,0,0,0,0,0,0,0,0,0,0,0,0,0,0,0,0,0,0,0,0,0,0,0,0,
0,0,0,0,0,0,0,0,0,0,0,0,0,0,0,0,0,0,0,0,0,0,0,0,0,0,0,0,0,0,0,0,0,0,0,0,0,0,0,0,0,0,0,0,0,0,0,0,0,0,0,0,0,0,0,0,0,0,0,0,
0,0,0,0,0,0,0,0,0,0,0,0,0,0,0,0,0,0,0,0,0,0,0,0,0,0,0,0,0,0,0,0,0,0,0,0,0,0,0,0,0,0,0,0,0,0,0,0,0,0,0,0,0,0,0,0,0,0,0,0,
0,0,0,0,0,0,0,0,0,0,0,0,0,0,0,0,0,0,0,0,0,0,0,0,0,0,0,0,0,0,0,0,0,0,0,0,0,0,0,0,0,0,0,0,0,0,0,0,0,0,0,0,0,0,0,0,0,0,0,0,
0,0,0,0,0,0,0,0,0,0,0,0,0,0,0,0,0,0,0,0,0,0,0,0,0,0,0,0,0,0,0,0,0,0,0,0,0,0,0,0,0,0,0,0,0,0,0,0,0,0,0,0,0,0,0,0,0,0,0,0,
0,0,0,0,0,0,0,0,0,0,0,0,0,0,0,0,0,0,0,0,0,0,0,0,0,0,0,0,0,0,0,0,0,0,0,0,0,0,0,0,0,0,0,0,0,0,0,0,0,0,0,0,0,0,0,0,0,0,0,0,
0,0,0,0,0,0,0,0,0,0,0,0,0,0,0,0,0,0,0,0,0,0,0,0,0,0,0,0,0,0,0,0,0,0,0,0,0,0,0,0,0,0,0,0,0,0,0,0,0,0,0,0,0,0,0,0,0,0,0,0,
0,0,0,0,0,0,0,0,0,0,0,0,0,0,0,0,0,0,0,0,0,0,0,0,0,0,0,0,0,0,0,0,0,0,0,0,0,0,0,0,0,0,0,0,0,0,0,0,0,0,0,0,0,0,0,0,0,0,0,0,
0,0,0,0,0,0,0,0,0,0,0,0,0,0,0,0,0,0,0,0,0,0,0,0,0,0,0,0,0,0,0,0,0,0,0,0,0,0,0,0,0,0,0,0,0,0,0,0,0,0,0,0,0,0,0,0,0,0,0,0,
0,0,0,0,0,0,0,0,0,0,0,0,0,0,0,0,0,0,0,0,0,0,0,0,0,0,0,0,0,0,0,0,0,0,0,0,0,0,0,0,0,0,0,0,0,0,0,0,0,0,0,0,0,0,0,0,0,0,0,0,
0,0,0,0,0,0,0,0,0,0,0,0,0,0,0,0,0,0,0,0,0,0,0,0,0,0,0,0,0,0,0,0,0,0,0,0,0,0,0,0,0,0,0,0,0,0,0,0,0,0,0,0,0,0,0,0,0,0,0,0,
0,0,0,0,0,0,0,0,0,0,0,0,0,0,0,0,0,0,0,0,0,0,0,0,0,0,0,0,0,0,0,0,0,0,0,0,0,0,0,0,0,0,0,0,0,0,0,0,0,0,0,0,0,0,0,0,0,0,0,0,
0,0,0,0,0,0,0,0,0,0,0,0,0,0,0,0,0,0,0,0,0,0,0,0,0,0,0,0,0,0,0,0,0,0,0,0,0,0,0,0,0,0,0,0,0,0,0,0,0,0,0,0,0,0,0,0,0,0,0,0,
0,0,0,0,0,0,0,0,0,0,0,0,0,0,0,0,0,0,0,0,0,0,0,0,0,0,0,0,0,0,0,0,0,0,0,0,0,0,0,0,0,0,0,0,0,0,0,0,0,0,0,0,0,0,0,0,0,0,0,0,
0,0,0,0,0,0,0,0,0,0,0,0,0,0,0,0,0,0,0,0,0,0,0,0,0,0,0,0,0,0,0,0,0,0,0,0,0,0,0,0,0,0,0,0,0,0,0,0,0,0,0,0,0,0,0,0,0,0,0,0,
0,0,0,0,0,0,0,0,0,0,0,0,0,0,0,0,0,0,0,0,0,0,0,0,0,0,0,0,0,0,0,0,0,0,0,0,0,0,0,0,0,0,0,0,0,0,0,0,0,0,0,0,0,0,0,0,0,0,0,0,
0,0,0,0,0,0,0,0,0,0,0,0,0,0,0,0,0,0,0,0,0,0,0,0,0,0,0,0,0,0,0,0,0,0,0,0,0,0,0,0,0,0,0,0,0,0,0,0,0,0,0,0,0,0,0,0,0,0,0,0,
0,0,0,0,0,0,0,0,0,0,0,0,0,0,0,0,0,0,0,0,0,0,0,0,0,0,0,0,0,0,0,0,0,0,0,0,0,0,0,0,0,0,0,0,0,0,0,0,0,0,0,0,0,0,0,0,0,0,0,0,
0,0,0,0,0,0,0,0,0,0,0,0,0,0,0,0,0,0,0,0,0,0,0,0,0,0,0,0,0,0,0,0,0,0,0,0,0,0,0,0,0,0,0,0,0,0,0,0,0,0,0,0,0,0,0,0,0,0,0,0,
0,0,0,0,0,0,0,0,0,0,0,0,0,0,0,0,0,0,0,0,0,0,0,0,0,0,0,0,0,0,0,0,0,0,0,0,0,0,0,0,0,0,0,0,0,0,0,0,0,0,0,0,0,0,0,0,0,0,0,0,
0,0,0,0,0,0,0,0,0,0,0,0,0,0,0,0,0,0,0,0,0,0,0,0,0,0,0,0,0,0,0,0,0,0,0,0,0,0,0,0,0,0,0,0,0,0,0,0,0,0,0,0,0,0,0,0,0,0,0,0,
0,0,0,0,0,0,0,0,0,0,0,0,0,0,0,0,0,0,0,0,0,0,0,0,0,0,0,0,0,0,0,0,0,0,0,0,0,0,0,0,0,0,0,0,0,0,0,0,0,0,0,0,0,0,0,0,0,0,0,0,
0,0,0,0,0,0,0,0,0,0,0,0,0,0,0,0,0,0,0,0,0,0,0,0,0,0,0,0,0,0,0,0,0,0,0,0,0,0,0,0,0,0,0,0,0,0,0,0,0,0,0,0,0,0,0,0,0,0,0,0,
0,0,0,0,0,0,0,0,0,0,0,0,0,0,0,0,0,0,0,0,0,0,0,0,0,0,0,0,0,0,0,0,0,0,0,0,0,0,0,0,0,0,0,0,0,0,0,0,0,0,0,0,0,0,0,0,0,0,0,0,
0,0,0,0,0,0,0,0,0,0,0,0,0,0,0,0,0,0,0,0,0,0,0,0,0,0,0,0,0,0,0,0,0,0,0,0,0,0,0,0,0,0,0,0,0,0,0,0,0,0,0,0,0,0,0,0,0,0,0,0,
0,0,0,0,0,0,0,0,0,0,0,0,0,0,0,0,0,0,0,0,0,0,0,0,0,0,0,0,0,0,0,0,0,0,0,0,0,0,0,0,0,0,0,0,0,0,0,0,0,0,0,0,0,0,0,0,0,0,0,0,
0,0,0,0,0,0,0,0,0,0,0,0,0,0,0,0,0,0,0,0,0,0,0,0,0,0,0,0,0,0,0,0,0,0,0,0,0,0,0,0,0,0,0,0,0,0,0,0,0,0,0,0,0,0,0,0,0,0,0,0,
0,0,0,0,0,0,0,0,0,0,0,0,0,0,0,0,0,0,0,0,0,0,0,0,0,0,0,0,0,0,0,0,0,0,0,0,0,0,0,0,0,0,0,0,0,0,0,0,0,0,0,0,0,0,0,0,0,0,0,0,
0,0,0,0,0,0,0,0,0,0,0,0,0,0,0,0,0,0,0,0,0,0,0,0,0,0,0,0,0,0,0,0,0,0,0,0,0,0,0,0,0,0,0,0,0,0,0,0,0,0,0,0,0,0,0,0,0,0,0,0

[layer]
type=THE_ONE_LAYER
data=
548,548,548,548,548,548,548,548,548,548,548,548,548,548,548,548,548,15,16,17,548,548,548,548,548,548,548,548,548,548,548,548,548,548,548,548,548,548,15,16,17,548,548,548,548,548,548,548,6,7,7,7,7,7,7,7,7,7,7,8,
548,548,548,548,548,548,548,548,548,548,548,548,548,548,548,548,548,45,44,47,548,548,548,548,548,548,548,548,548,548,548,548,548,548,548,548,548,548,45,46,47,548,548,548,548,548,548,548,36,302,302,302,302,302,302,302,302,302,302,38,
548,548,548,548,548,548,548,548,548,548,548,548,548,548,548,548,548,75,76,77,548,548,548,548,548,548,548,548,548,548,548,548,548,548,548,548,548,548,75,78,77,548,548,548,548,548,548,548,66,7,7,7,7,7,7,7,7,40,211,38,
1,2,2,2,2,2,2,2,2,2,2,2,2,2,2,2,2,2,2,2,2,2,2,2,2,2,2,2,2,2,2,2,2,2,2,2,2,2,2,2,2,2,2,2,2,2,2,2,2,2,2,2,2,2,2,2,2,3,557,36,
31,672,769,770,770,770,770,770,770,770,770,770,770,771,672,4,62,62,62,62,62,62,62,62,62,62,62,62,62,62,62,62,62,62,62,62,62,62,62,62,62,62,62,62,62,62,62,62,62,62,62,5,769,770,770,770,771,33,557,36,
31,672,799,769,770,770,770,770,770,770,770,770,771,801,672,33,91,92,92,92,95,391,94,92,92,92,92,92,92,92,92,92,92,92,92,92,92,96,92,92,92,92,96,95,361,94,92,92,92,92,95,31,799,27,28,29,801,33,557,36,
31,672,799,799,769,770,770,770,770,770,770,771,801,801,672,33,121,11,6,8,6,8,6,8,6,8,6,8,6,8,6,8,6,8,6,7,8,123,1,2,2,3,123,1,2,2,2,2,2,2,2,35,799,57,58,59,801,33,557,36,
31,672,799,799,799,549,550,551,552,672,672,801,801,801,672,33,123,38,38,38,38,38,38,38,38,38,38,38,38,38,38,38,38,38,36,301,38,123,61,62,62,63,123,61,62,62,62,62,62,62,62,5,799,87,88,89,801,33,557,36,
31,672,799,799,799,579,580,581,582,4,5,801,801,801,672,33,123,38,36,38,36,38,36,38,36,38,36,38,36,38,36,38,36,38,38,212,38,125,98,98,98,98,156,96,95,421,94,92,92,92,95,31,829,830,830,773,801,33,557,36,
31,672,799,799,799,609,610,611,612,34,35,801,801,801,672,33,123,66,68,66,68,66,68,66,68,66,68,66,68,66,68,66,68,66,68,124,38,123,1,2,2,2,3,123,1,2,2,2,2,2,2,35,32,32,32,799,801,33,557,36,
31,672,799,799,799,639,640,641,642,4,5,801,801,801,672,33,123,6,7,7,7,7,7,7,7,7,7,7,7,7,7,7,7,7,8,123,38,123,61,62,62,62,63,123,61,62,62,62,62,62,62,5,769,771,32,799,801,33,557,36,
31,672,799,799,799,672,670,671,672,34,35,801,801,801,672,33,123,36,1,2,2,2,2,2,2,2,2,2,2,2,2,2,2,3,38,123,38,125,92,92,92,92,92,156,96,92,92,92,92,92,95,31,829,831,32,799,801,33,557,36,
31,672,799,799,829,830,830,830,830,830,830,831,801,801,672,33,123,36,31,769,770,770,770,771,541,542,543,544,769,770,770,770,771,33,38,123,38,123,1,2,2,2,2,3,123,1,2,2,2,2,2,35,32,32,32,799,801,33,557,36,
31,672,799,829,830,830,830,830,830,830,830,830,831,801,672,33,123,36,31,799,27,28,29,801,571,572,573,574,799,27,28,29,801,33,38,121,38,123,31,541,542,543,544,33,123,61,62,62,62,62,62,5,769,770,770,803,801,33,557,36,
31,672,829,830,830,830,830,830,830,830,830,830,830,831,672,33,123,36,31,799,57,58,59,801,601,602,603,604,799,57,58,59,801,33,38,123,38,451,31,571,572,573,574,33,151,92,92,92,95,181,122,31,799,27,28,29,801,33,557,36,
31,672,672,672,4,5,672,672,672,672,4,5,672,769,771,33,123,36,31,799,87,88,89,801,631,632,633,634,799,87,88,89,801,33,38,123,38,123,31,601,602,603,604,34,2,2,2,2,2,2,2,35,799,57,58,59,801,33,557,36,
31,672,672,672,34,35,672,672,672,672,34,35,672,829,831,33,123,36,31,829,830,830,830,831,661,662,663,664,829,830,830,830,831,33,38,123,38,123,31,631,632,633,634,800,800,800,800,800,800,800,800,800,799,87,88,89,801,33,557,36,
31,672,4,62,62,62,62,62,62,62,62,62,62,62,62,63,123,41,61,62,62,62,62,62,62,62,62,62,62,62,62,62,62,63,41,123,41,123,31,661,662,663,664,800,800,800,800,800,800,800,800,800,829,830,830,830,831,33,557,36,
31,672,33,91,92,92,92,92,92,92,92,92,92,92,92,92,155,152,92,92,95,421,94,92,92,92,92,92,92,92,92,92,92,92,92,155,92,126,61,62,62,62,62,62,62,62,62,62,62,62,62,62,62,62,62,62,62,63,557,36,
31,672,33,123,1,2,2,2,2,2,2,2,2,2,2,3,123,11,1,2,2,2,2,2,2,2,2,2,2,2,2,2,2,3,11,123,11,151,92,182,92,92,92,92,92,92,92,92,92,92,92,92,92,92,92,92,95,271,557,36,
31,672,33,123,31,769,771,769,771,769,771,769,771,769,771,33,123,36,31,769,770,770,770,771,549,550,551,552,769,770,770,770,771,33,36,123,36,1,2,2,2,2,2,2,2,2,2,2,2,2,2,2,2,2,2,2,2,3,557,36,
31,672,33,123,31,829,831,829,831,829,831,829,831,829,831,33,123,36,31,799,27,28,29,801,579,580,581,582,799,27,28,29,801,33,36,123,36,31,541,542,543,544,800,800,800,800,800,800,800,800,800,800,800,541,542,543,544,33,557,36,
31,672,33,123,31,769,771,769,771,769,771,769,771,769,771,33,123,36,31,799,57,58,59,801,609,610,611,612,799,57,58,59,801,33,36,154,36,31,571,572,573,574,549,550,551,555,550,551,555,550,551,552,83,571,572,573,574,33,557,36,
31,672,33,123,31,829,831,829,831,829,831,829,831,829,831,33,123,36,31,799,87,88,89,801,639,640,641,642,799,87,88,89,801,33,36,212,36,31,601,602,603,604,579,580,581,585,580,581,585,580,581,582,83,601,602,603,604,33,557,36,
31,672,33,123,61,62,62,62,62,62,62,62,62,62,62,63,123,36,31,829,830,830,830,831,661,670,671,672,829,830,830,830,831,33,36,301,38,31,631,632,633,634,609,610,611,615,610,611,615,610,611,612,83,631,632,633,634,33,557,36,
31,672,33,151,95,361,94,92,92,92,92,92,92,92,92,92,153,41,61,62,62,62,62,62,62,62,62,62,62,62,62,62,62,63,66,7,68,31,661,662,663,664,639,640,641,645,640,641,645,640,641,642,83,661,662,663,664,33,557,36,
31,672,34,2,2,2,2,2,2,2,2,2,2,2,2,2,2,2,2,2,2,2,2,2,2,2,2,2,2,2,2,2,2,2,2,2,2,35,800,800,800,800,800,670,671,672,670,671,672,670,671,672,800,800,800,800,800,33,557,36,
61,62,62,62,62,62,62,62,62,62,62,62,62,62,62,62,62,62,62,62,62,62,62,62,62,62,62,62,62,62,62,62,62,62,62,62,62,62,62,62,62,62,62,62,62,62,62,62,62,62,62,62,62,62,62,62,62,63,557,36,
548,548,548,548,548,15,16,17,548,548,548,548,548,548,548,548,548,548,548,548,548,548,548,548,548,548,548,548,548,548,548,548,548,548,548,548,548,548,548,548,548,548,548,548,548,548,548,548,548,6,7,7,7,7,7,7,7,40,211,36,
548,548,548,548,548,45,44,47,548,548,548,548,548,548,548,548,548,548,548,548,548,548,548,548,548,15,16,17,548,548,548,548,548,548,548,548,548,548,548,548,548,548,548,548,548,548,548,548,548,36,302,302,302,302,302,302,302,302,302,38,
548,548,548,548,548,75,76,77,548,548,548,548,548,548,548,548,548,548,548,548,548,548,548,548,548,45,44,47,548,548,548,548,548,548,548,548,548,548,548,548,548,548,548,548,548,548,548,548,548,66,7,7,7,7,7,7,7,7,7,68

