12
11
1  1  1  1  1  1  1  1  1  1 1 1
1  2  2  2  2  2  2  2  2  2 2 2
1  2  1  1  1  1  1  1  2  1 1 2
1  2  1  2  4  2  4  1  2  1 2 2
1  2  1  2  2  2  2  1  2  1 2 6
1  2  1  2  6  2  4  1  2  1 2 1
1  2  1  1  1  1  1  1  2  1 2 2
1  2  1  1  1  1  1  1  2  1 1 2
1  2  2  2  2  2  2  2  2  1 2 2
1  1  1  7  1  1  1  1  2  2 2 1
1  1  1  2  2  2  3  1  1  1 1 1