1  1  1  1  1  1  1  1  1  1  1  1  1
1  5  2  2  2  2  2  2  2  2  2  2  1
1  2  1  1  1  1  1  1  2  1  1  2  1
1  2  1  2  4  2  4  1  2  1  2  2  1
1  2  1  2  2  2  2  1  2  1  2  6  1
1  2  1  2  6  2  4  1  2  1  2  1  1
1  2  1  2  2  2  7  1  2  1  2  2  1
1  2  1  1  1  1  1  1  2  1  1  2  1
1  2  2  2  2  2  2  2  2  1  2  2  1
1  1  1  7  1  1  1  1  2  2  2  1  1
2  2  1  2  2  2  3  1  1  1  1  1  1
1  1  1  1  1  1  1  1  1  1  1  1  1

2
4 9
5 9
1
1 2