13
12
1  1  1  1  1  1  1  1  1  1  1  1  1
1  1  1  1  1  1  1  1  1  1  1  1  1
1  1  1  1  1  1  1  1  1  1  1  1  1
1  1  1  1  1  1  1  1  1  1  1  1  1
1  1  1  1  1  1  1  1  1  1  1  1  1
1  1  1  1  1  1  1  1  1  1  1  1  1
1  1  2  0  0  0  0  0  0  0  0  0  1
1  1  1  1  1  1  1  1  1  1  1  0  1
1  1  1  1  1  1  1  1  1  1  1  0  1
1  1  1  1  1  1  1  1  1  1  1  1  1
1  1  3  0  0  0  7  0  0  0  0  0  1
1  1  1  1  1  1  1  1  1  1  1  1  1

1
11 2